VectorID,ProblemID,TargetWeight,AchievedWeight,Fitness,Generations,DurationMs,TerminationReason,SolutionItems
1,1,521524,521371,153,5,3.328,no_improvement,0 7 8 15 18
1,2,157248,158065,817,2,1.085,no_improvement,2 19 20
1,3,1309477,1309441,36,6,3.632,no_improvement,0 2 4 8 10 13 14 15 17 19 20 22 23
1,4,389440,388928,512,2,1.640,no_improvement,1 7 8 15 20
1,5,916537,916529,8,7,3.593,no_improvement,0 4 7 10 14 18 22
1,6,833583,833608,25,7,4.028,no_improvement,4 5 6 7 8 10 11 12 15 16 18
1,7,789267,789208,59,2,1.002,no_improvement,0 2 3 7 8 12 13 14 16 21 23
1,8,1042447,1042338,109,6,4.601,no_improvement,1 3 5 9 11 12 14 16 17 18 19 20 22
1,9,577535,577553,18,4,2.163,no_improvement,1 3 6 8 16 17 21 23
1,10,667986,668158,172,2,2.201,no_improvement,1 2 9 10 11 12 14 19 21
1,11,542586,542548,38,2,1.012,no_improvement,3 6 8 9 10 16 19
1,12,580663,580609,54,2,1.435,no_improvement,1 3 4 6 8 11 15 19 21 22 23
1,13,200114,200161,47,5,3.119,no_improvement,16 21
1,14,955460,955432,28,8,4.637,no_improvement,0 4 8 11 13 14 16 18 19 21 22
1,15,734950,735017,67,2,1.375,no_improvement,6 7 10 12 14 15 16 21
2,1,541175,541163,12,2,1.999,no_improvement,4 7 8 10 12 17 19
2,2,650309,650350,41,2,1.273,no_improvement,0 1 3 7 8 9 13 16 18 22
2,3,355750,355823,73,6,3.391,no_improvement,2 8 9 13 14 19 21
2,4,587854,587709,145,4,2.298,no_improvement,0 2 4 6 10 12 14 16 17 20 21
2,5,711150,711145,5,2,1.466,no_improvement,1 3 5 8 9 10 11 16 17 21
2,6,186698,186534,164,5,2.741,no_improvement,1 3 8 10 15 19 20 23
2,7,401257,401551,294,2,1.434,no_improvement,0 1 5 6 9 10 14 20 21
2,8,297636,297636,0,2,1.021,zero_fitness,3 6
2,9,679441,679411,30,2,2.547,no_improvement,0 1 5 6 8 9 10 17 18
2,10,448587,448676,89,2,1.012,no_improvement,1 13 14 15 17 18 21 22
2,11,219456,219405,51,4,2.223,no_improvement,5 10 14 17
2,12,173214,173244,30,7,4.104,no_improvement,4 19
2,13,358175,358286,111,4,2.004,no_improvement,1 3 7 11 13 17 21 23
2,14,451545,451509,36,2,2.042,no_improvement,0 1 7 8 9 10 13 17 18 19 22
2,15,454437,454477,40,4,2.991,no_improvement,0 3 6 8 11 13 15
3,1,297862,297867,5,4,3.489,no_improvement,3 8 9 11 14 17 19 21 22
3,2,359395,359377,18,6,3.280,no_improvement,3 12 13 16 21
3,3,618212,618168,44,3,1.399,no_improvement,9 10 11 12 13 18 23
3,4,288346,288364,18,3,2.557,no_improvement,5 6 9 15 17 21
3,5,308124,308103,21,4,3.028,no_improvement,2 3 4 15 17 18 19
3,6,539399,539328,71,2,1.085,no_improvement,0 1 7 12 22 23
3,7,90417,90417,0,2,1.290,zero_fitness,2 17
3,8,217331,217766,435,3,1.020,no_improvement,2 3 6 7
3,9,514472,514473,1,4,2.532,no_improvement,11 14 19 20
3,10,820652,820658,6,6,3.367,no_improvement,1 2 4 5 8 10 11 13 15 19 21 23
3,11,31801,31801,0,3,1.022,zero_fitness,3 16 21 22
3,12,668447,668479,32,3,2.009,no_improvement,0 2 5 8 10 11 15 23
3,13,629153,629125,28,6,4.118,no_improvement,6 7 10 13 14 15 22 23
3,14,703263,703129,134,5,2.430,no_improvement,2 3 4 6 8 10 14 18 19 23
3,15,465253,465197,56,4,2.307,no_improvement,1 2 9 14 17 18 19 21
4,1,211716,211706,10,7,4.496,no_improvement,0 1 3 9 11 12 21
4,2,391985,391925,60,5,2.220,no_improvement,1 6 9 12 14 17 18 21 22
4,3,909561,909568,7,3,2.375,no_improvement,0 3 4 5 6 10 13 16 17 19 20
4,4,691138,691178,40,6,3.544,no_improvement,0 6 8 9 10 11 12 15 20 22
4,5,206934,206946,12,8,4.509,no_improvement,3 9 13 16
4,6,176307,176308,1,6,4.817,no_improvement,4 8 12 15 16 18
4,7,73613,73613,0,6,3.006,zero_fitness,2 11
4,8,138292,138218,74,6,3.726,no_improvement,7 16
4,9,684425,684463,38,2,1.395,no_improvement,0 7 9 13 15 19
4,10,166276,165573,703,3,2.192,no_improvement,0 3 8 11 12 14 20 23
4,11,197912,197936,24,11,4.824,no_improvement,3 13 16 18
4,12,871326,871309,17,4,3.613,no_improvement,0 2 6 7 9 11 12 14 15 18 20 21
4,13,209902,209106,796,2,1.074,no_improvement,1 2 12 16 18
4,14,444533,444564,31,2,2.004,no_improvement,1 13 16 19 20 22
4,15,467732,467722,10,7,3.898,no_improvement,0 1 3 5 9 11 12 13 14
5,1,88319,86239,2080,4,2.051,no_improvement,7 10 11 13
5,2,133752,133736,16,8,4.682,no_improvement,3 5 6 7 8 11 18 20 21 23
5,3,691205,691053,152,2,0.998,no_improvement,1 3 5 8 10 11 13 17 19 23
5,4,519165,519151,14,5,3.406,no_improvement,0 5 7 12 19 21
5,5,418392,418536,144,4,2.180,no_improvement,1 3 4 5 6 7 8 10 14 15 16 18 20
5,6,325951,325937,14,5,3.397,no_improvement,1 2 5 6 7 8 10 11 15 16
5,7,373151,373165,14,6,3.537,no_improvement,0 1 4 6 9 10 11 14 15 16 19 21 23
5,8,378333,378303,30,2,2.073,no_improvement,5 7 10 13 14 15 22
5,9,678239,678386,147,3,2.105,no_improvement,1 2 3 6 7 11 12 13 14 21
5,10,309891,309884,7,2,1.160,no_improvement,1 4 7 9 13 16 17
5,11,74626,74629,3,8,4.983,no_improvement,3 5 7 16 20
5,12,598155,598161,6,8,4.180,no_improvement,0 3 4 5 9 10 19 20 23
5,13,30910,30910,0,3,2.007,zero_fitness,7 15 18
5,14,393733,393689,44,3,2.000,no_improvement,0 4 8 10 13 16 20
5,15,677979,678002,23,3,2.037,no_improvement,0 3 4 5 6 12 14 16 17 18 22
6,1,195889,195843,46,6,3.004,no_improvement,12 16 21
6,2,983938,983948,10,4,2.121,no_improvement,1 3 4 5 7 8 11 12 13 20 21
6,3,329167,329301,134,3,2.053,no_improvement,11 12 16 18 22
6,4,485551,485555,4,7,4.539,no_improvement,1 6 7 8 10 12 18 19 22
6,5,814758,814794,36,2,1.024,no_improvement,0 6 7 8 12 15 16 17 19 20 21 23
6,6,343333,343361,28,6,3.093,no_improvement,5 7 9 10 13 16
6,7,889813,889835,22,7,4.309,no_improvement,0 1 2 3 4 7 8 9 10 11 13 14 19
6,8,283409,282536,873,3,2.108,no_improvement,3 7 12 16 18
6,9,378517,378449,68,4,2.269,no_improvement,1 3 9 15 21
6,10,620979,621013,34,3,2.245,no_improvement,0 1 8 9 12 14 18 20 21
6,11,859445,859454,9,5,2.550,no_improvement,2 6 8 13 16 17 18 20
6,12,184443,184555,112,5,3.392,no_improvement,5 10 13
6,13,850202,850224,22,5,2.214,no_improvement,0 4 7 10 11 13 17 20 21 22
6,14,242600,242613,13,7,2.667,no_improvement,7 11 21 22
6,15,813164,813139,25,4,3.102,no_improvement,0 2 4 6 8 11 16 17 23
7,1,222981,222974,7,2,1.002,no_improvement,2 6 10 11
7,2,359818,359848,30,2,1.436,no_improvement,2 7 9 16
7,3,601848,602077,229,3,2.004,no_improvement,0 7 8 11 13 15 16 17 21 23
7,4,606191,606245,54,5,2.897,no_improvement,4 13 14 16 18 22 23
7,5,613368,613393,25,3,2.055,no_improvement,3 4 5 7 12 14 20
7,6,334026,333996,30,5,3.332,no_improvement,0 2 4 8 11 12 15 16 17 21 22
7,7,463037,463033,4,4,2.044,no_improvement,3 5 6 8 11 13 19
7,8,426985,427013,28,4,2.696,no_improvement,0 3 5 6 14 18
7,9,670357,670425,68,2,2.080,no_improvement,0 3 6 7 8 11 16 19 20 21 22
7,10,1092909,1092796,113,4,2.074,no_improvement,1 5 8 9 10 13 17 19 23
7,11,848605,848716,111,2,1.090,no_improvement,3 5 9 10 15 17 18 21 22 23
7,12,814995,815193,198,2,2.328,no_improvement,1 2 7 9 11 14 16 18 19 21
7,13,73257,78823,5566,3,1.001,no_improvement,4 7 10 14 17 18
7,14,542873,542873,0,2,2.522,zero_fitness,0 4 5 15 19 20 21
7,15,262004,261975,29,6,3.071,no_improvement,15 16 19
8,1,484218,484149,69,4,2.165,no_improvement,1 9 14 15 16 21
8,2,313097,313080,17,6,3.858,no_improvement,4 5 7 8 13 14 16 21
8,3,764546,764552,6,5,2.081,no_improvement,1 3 5 13 14 15 16 19
8,4,936262,936303,41,3,2.482,no_improvement,0 1 2 3 4 6 7 9 12 14 15 20 22
8,5,321842,321878,36,9,4.136,no_improvement,0 5 7 12 14 19 21 23
8,6,701690,701757,67,2,2.518,no_improvement,0 3 4 6 7 10 11 12 13 15 17 19 23
8,7,691846,691865,19,6,3.251,no_improvement,1 2 3 4 5 6 7 9 11 14 16 19 23
8,8,1088165,1088199,34,3,1.002,no_improvement,2 3 6 8 9 10 11 12 15 17 18 20 22
8,9,784842,784851,9,7,4.074,no_improvement,0 3 6 9 12 15 16 17 18 22 23
8,10,298618,298618,0,2,1.200,zero_fitness,0 9 11 14 16
8,11,43463,43463,0,2,1.377,zero_fitness,5 6
8,12,971938,971938,0,4,2.100,zero_fitness,1 5 8 9 10 11 13 17 18 20 21 22
8,13,129372,129296,76,4,2.014,no_improvement,3 6 11 14
8,14,659446,659477,31,3,2.486,no_improvement,0 1 6 7 11 12 13 14 18 19 21 22 23
8,15,674296,674251,45,4,2.019,no_improvement,1 4 6 7 8 12 15 19 21 22
9,1,144239,144407,168,5,2.026,no_improvement,1 6 8 10
9,2,442786,442814,28,5,3.357,no_improvement,0 4 6 8 9 13 18 21 22
9,3,463261,463043,218,4,1.351,no_improvement,1 4 6 8 12 14 15 16 17 20
9,4,450544,450549,5,2,2.521,no_improvement,2 6 10 12 13 14 15 17 19 21 23
9,5,35169,25559,9610,2,1.303,no_improvement,10
9,6,296095,296098,3,2,1.368,no_improvement,0 6 7 9 11 12 18 21 22 23
9,7,232153,232208,55,3,1.410,no_improvement,1 2 5 15 16 18 19 23
9,8,211042,210955,87,5,3.619,no_improvement,2 12 20
9,9,396629,396660,31,4,2.523,no_improvement,1 2 5 7 8 12 22
9,10,475612,475606,6,6,3.139,no_improvement,1 3 5 6 7 11 13 17 20 21
9,11,469047,469068,21,2,2.045,no_improvement,2 3 4 5 9 10 12 13 17 18 19
9,12,117832,118715,883,2,1.066,no_improvement,2 6 12 13 22
9,13,240366,240433,67,4,2.107,no_improvement,2 3 7 13 14 18
9,14,401022,400877,145,3,2.019,no_improvement,0 5 8 13 17 18 19 21 23
9,15,441091,441132,41,3,2.147,no_improvement,2 4 7 10 11 12 13 16 17 21
10,1,582817,582800,17,5,2.208,no_improvement,2 8 9 10 11 12 17 20 21 22
10,2,652539,652512,27,3,2.313,no_improvement,6 7 8 9 10 14 18 19
10,3,314064,314136,72,3,2.511,no_improvement,2 3 7 8 11 15 23
10,4,70189,69697,492,3,1.018,no_improvement,7 11
10,5,759681,759707,26,3,2.280,no_improvement,1 6 8 9 11 12 15 16 20 21 22
10,6,459248,459242,6,4,3.280,no_improvement,5 13 16 20
10,7,323468,323468,0,1,0.000,zero_fitness,16 17 18 19
10,8,922023,921971,52,10,5.853,no_improvement,3 6 7 10 13 14 16 18 20 23
10,9,317802,318061,259,2,1.492,no_improvement,3 19 20 21 23
10,10,419657,419662,5,3,2.023,no_improvement,0 6 8 9 11 19
10,11,122287,122152,135,8,4.484,no_improvement,2 3 8
10,12,323665,323667,2,3,1.352,no_improvement,0 1 3 6 8 13 19 20
10,13,264244,264356,112,3,2.427,no_improvement,1 2 5 19 21 23
10,14,402666,402356,310,2,1.036,no_improvement,6 11 14 18 20 22
10,15,212694,212301,393,5,3.221,no_improvement,0 1 12 18 19 21 22
11,1,471213,471186,27,3,2.083,no_improvement,1 2 8 9 13 20 23
11,2,261313,261329,16,5,2.169,no_improvement,8 10 11 16 21
11,3,372272,372334,62,4,2.393,no_improvement,3 4 5 9 10 14 21
11,4,669588,669774,186,3,2.162,no_improvement,0 1 4 5 11 12 18 21
11,5,687083,687128,45,6,3.680,no_improvement,0 3 5 7 8 10 12 14 16 18 22 23
11,6,339257,339208,49,8,4.341,no_improvement,5 7 9 20 22 23
11,7,91867,98853,6986,2,1.169,no_improvement,0 5 12 14 15 22
11,8,432488,432503,15,4,3.310,no_improvement,6 8 14 15 21
11,9,263847,263975,128,2,0.000,no_improvement,0 2 3 5 10 14 19
11,10,837335,837295,40,3,2.582,no_improvement,2 4 10 11 12 15 16 19 21
11,11,440419,440415,4,2,2.124,no_improvement,5 9 11 18 19 22 23
11,12,323572,323505,67,4,2.101,no_improvement,1 7 11 14 19
11,13,418998,419013,15,4,2.772,no_improvement,1 2 4 5 14 19 22
11,14,283280,283253,27,2,1.005,no_improvement,0 4 7 10 12 18 20
11,15,409445,409397,48,9,4.426,no_improvement,4 6 10 11 12 14 15 18 19 20 22
12,1,242377,242416,39,4,3.157,no_improvement,3 5 8 22 23
12,2,300538,300522,16,5,2.003,no_improvement,4 5 10 11 13 15 16 17 21 22 23
12,3,121969,121969,0,10,5.096,zero_fitness,0 17
12,4,328485,328485,0,5,3.500,zero_fitness,1 4 6 7 17 21
12,5,308661,308759,98,3,1.032,no_improvement,2 7 9 10 14
12,6,224709,224775,66,6,3.289,no_improvement,2 4 9 12 16 22 23
12,7,542247,541974,273,3,1.111,no_improvement,1 6 8 11 14 17 20 22
12,8,637349,637357,8,3,2.062,no_improvement,0 5 11 12 13 14 18 19 21 22
12,9,629927,630102,175,3,2.373,no_improvement,0 4 5 8 15 20 23
12,10,480224,480175,49,3,1.000,no_improvement,0 5 13 14 16 20 23
12,11,238637,238976,339,4,2.618,no_improvement,0 4 9 18 22
12,12,419497,419619,122,3,1.035,no_improvement,0 14 15 19
12,13,114471,114479,8,6,4.397,no_improvement,0 18 23
12,14,229337,229311,26,6,4.459,no_improvement,0 10 12 20
12,15,619261,619262,1,5,2.473,no_improvement,0 2 5 6 7 11 13 14 16 17 18
13,1,338540,338492,48,6,3.573,no_improvement,6 8 14 20 21
13,2,627125,627131,6,2,1.212,no_improvement,3 6 12 14 15 18 19 20 23
13,3,508963,508969,6,2,1.501,no_improvement,4 5 7 8 9 12 16 20 21 22
13,4,411215,411235,20,8,4.570,no_improvement,0 3 8 9 10 11 17 19 21 23
13,5,276803,276838,35,5,3.195,no_improvement,2 7 9 10 17 19 21
13,6,816168,816160,8,4,2.006,no_improvement,1 2 3 5 6 8 9 13 14 18 19 21 22 23
13,7,240166,239873,293,3,2.073,no_improvement,2 4 8 9 10 14
13,8,479853,479808,45,3,2.465,no_improvement,6 11 12 16 18 21 23
13,9,549925,550109,184,3,2.091,no_improvement,1 2 3 5 13 15 22 23
13,10,481046,481055,9,3,1.002,no_improvement,7 8 10 15 16 19 20 22
13,11,574688,574549,139,2,2.644,no_improvement,1 2 6 12 13 15 20 21 23
13,12,348790,349182,392,2,1.082,no_improvement,7 15 16 22 23
13,13,537834,537844,10,3,1.496,no_improvement,4 5 7 8 9 13 16 19 22 23
13,14,143371,143687,316,7,4.107,no_improvement,6 18
13,15,540386,540311,75,4,1.032,no_improvement,3 4 5 10 12 15 16 17 18 19 21 23
14,1,375580,375605,25,4,2.643,no_improvement,0 1 2 3 8 10 14 16 18 20
14,2,208813,208730,83,3,1.042,no_improvement,2 3 4 6 11 20
14,3,899095,899108,13,6,3.441,no_improvement,3 4 6 7 8 9 12 14 16 17 18 22 23
14,4,637583,637522,61,4,2.350,no_improvement,0 3 4 6 9 10 15 17 18 20 23
14,5,445876,445895,19,2,2.086,no_improvement,1 2 4 7 8 22
14,6,596972,597056,84,8,4.729,no_improvement,0 3 6 7 11 13 14 16 18 19 23
14,7,334672,334804,132,2,1.003,no_improvement,2 5 7 9 12 14 18
14,8,784589,784658,69,4,2.438,no_improvement,0 4 7 9 11 12 15 16 20 21 22 23
14,9,746658,746574,84,2,2.162,no_improvement,1 4 8 9 10 11 14 15 16 17 20 23
14,10,276691,276669,22,7,3.308,no_improvement,1 2 6 10 11 13 18 20
14,11,446254,446314,60,3,2.202,no_improvement,0 4 13 19 20 22
14,12,792285,792284,1,8,4.480,no_improvement,0 1 2 3 6 7 10 13 14 19 21 22 23
14,13,303796,303811,15,5,3.144,no_improvement,0 6 8 9 11 13
14,14,687303,687355,52,4,2.406,no_improvement,1 6 12 13 14 16 17 18 21 23
14,15,173198,173174,24,2,1.022,no_improvement,0 19
15,1,349304,349353,49,7,2.523,no_improvement,3 9 12 13 15 18 21
15,2,219893,220125,232,2,1.154,no_improvement,3 16 19
15,3,250725,250649,76,5,2.481,no_improvement,8 13 14 16 19
15,4,656598,656575,23,4,2.122,no_improvement,0 3 4 7 13 17 19 21
15,5,456546,456563,17,7,4.043,no_improvement,5 6 8 9 13 16 17 18
15,6,699620,699668,48,2,1.151,no_improvement,1 2 9 10 11 18 22 23
15,7,277342,277618,276,4,3.207,no_improvement,0 8 12 13
15,8,840912,840928,16,6,3.042,no_improvement,0 1 2 4 7 8 9 15 16 20 21
15,9,277077,277114,37,12,5.530,no_improvement,0 4 11 14 23
15,10,766133,766170,37,6,2.618,no_improvement,2 3 4 11 12 13 14 17 19 22
15,11,528075,528006,69,4,1.500,no_improvement,3 4 6 7 8 10 11
15,12,587846,588040,194,2,1.409,no_improvement,2 4 8 12 15 16 17 18
15,13,1091872,1091929,57,6,3.052,no_improvement,1 2 4 5 7 8 13 17 18 19 20 23
15,14,978136,978198,62,6,3.432,no_improvement,2 5 7 10 11 15 16 17 19
15,15,317364,317455,91,5,3.218,no_improvement,2 8 15 16 20
16,1,506923,506945,22,6,3.091,no_improvement,1 2 4 10 14 17 20 21
16,2,99192,98725,467,5,3.182,no_improvement,7 10 11 12 20
16,3,781463,781353,110,4,2.503,no_improvement,2 3 4 5 7 9 12 14 15 16 17 20
16,4,792499,792458,41,3,1.194,no_improvement,0 2 3 5 11 16 17 18 20 21
16,5,223123,222993,130,4,2.545,no_improvement,4 6 10 16 21
16,6,559597,559621,24,2,2.129,no_improvement,1 5 6 9 10 14 15 17 19 20 23
16,7,441111,441148,37,4,2.174,no_improvement,9 10 16 18 19 22
16,8,209691,209660,31,2,1.508,no_improvement,9 12 15 16 20 22
16,9,402678,402681,3,3,2.028,no_improvement,10 11 12 15 16
16,10,840581,840596,15,4,2.008,no_improvement,0 1 3 8 13 15 18 19 20 21 23
16,11,116564,114688,1876,2,1.003,no_improvement,0 2 6 7 12 16 17 22 23
16,12,633929,634030,101,2,1.008,no_improvement,0 3 4 6 8 13 14 16
16,13,246031,246028,3,3,2.058,no_improvement,3 9 11 15 18 21
16,14,462960,462901,59,3,2.011,no_improvement,0 3 10 12 15 21 22
16,15,596932,596808,124,2,2.016,no_improvement,1 3 5 6 14 17 19 21 22
17,1,241258,241258,0,2,1.391,zero_fitness,7 17 23
17,2,999118,999114,4,8,4.015,no_improvement,2 3 6 7 8 9 10 11 13 15 16 20 21 23
17,3,615475,615490,15,3,2.017,no_improvement,3 4 5 6 7 14 15 16 17 22 23
17,4,258870,258854,16,5,3.106,no_improvement,2 3 6 11 13 15 21 22 23
17,5,622474,622450,24,3,2.060,no_improvement,1 5 7 8 10 11 17 20 21 23
17,6,555153,555181,28,2,2.133,no_improvement,1 3 4 5 6 10 11 13 18 23
17,7,761195,761252,57,3,2.072,no_improvement,1 2 3 4 5 10 11 12 15 18 19 20 22
17,8,529820,529809,11,2,1.500,no_improvement,0 5 6 9 10 14 16 17 18
17,9,688803,688741,62,3,1.348,no_improvement,2 3 7 8 9 11 15 17 20
17,10,365192,365124,68,5,4.323,no_improvement,1 3 4 6 8 11 20
17,11,154057,154045,12,3,1.512,no_improvement,0 2 7 8 16 18 22 23
17,12,660225,660248,23,5,4.276,no_improvement,3 5 7 9 12 13 14 15 17 20
17,13,284841,284825,16,5,3.339,no_improvement,1 3 11 13 15 16
17,14,494069,494151,82,3,3.788,no_improvement,3 6 8 9 10 11 22 23
17,15,112051,112132,81,6,5.120,no_improvement,1 3 18 22
18,1,675454,675526,72,2,2.015,no_improvement,3 4 6 9 11 15 18 21 23
18,2,466886,467028,142,4,3.498,no_improvement,0 3 4 6 7 12 13 14 15 19
18,3,419261,419282,21,6,3.160,no_improvement,0 3 4 9 10 12 13 14
18,4,661322,661228,94,2,0.976,no_improvement,3 4 5 9 12 13 20 21 23
18,5,403928,404022,94,2,2.138,no_improvement,9 11 12 13 15 16 18
18,6,39169,39169,0,3,1.506,zero_fitness,0 16
18,7,215628,215613,15,2,2.035,no_improvement,0 1 9 19 23
18,8,154935,154862,73,5,3.321,no_improvement,3 5 9 14 16 19 21
18,9,568859,568787,72,3,2.617,no_improvement,1 2 5 6 9 10 18 19 22
18,10,208534,208413,121,5,2.703,no_improvement,5 11 13 15 16 17 21
18,11,118079,117987,92,9,4.611,no_improvement,7 9 21 22
18,12,226111,225772,339,5,2.170,no_improvement,7 8 9 15 19
18,13,766996,767008,12,7,4.252,no_improvement,1 6 9 12 16 17 18 19 20
18,14,307228,307284,56,2,1.342,no_improvement,1 3 7 12 16 17 22
18,15,383466,383544,78,5,3.600,no_improvement,0 3 5 7 8 12 16
19,1,144952,145068,116,5,3.344,no_improvement,2 3 8 10 11 16
19,2,191405,191389,16,6,3.350,no_improvement,6 8 10
19,3,865301,865324,23,4,2.202,no_improvement,3 4 6 7 10 11 13 14 15 18 23
19,4,189742,189515,227,3,2.247,no_improvement,5 10 15
19,5,674589,674609,20,5,2.522,no_improvement,0 5 6 9 10 12 15 17 20
19,6,507268,507312,44,4,2.067,no_improvement,6 7 9 10 12 13 16
19,7,554979,555010,31,5,3.196,no_improvement,2 4 8 9 14 16 18
19,8,1001490,1001467,23,6,3.495,no_improvement,1 3 6 7 8 10 11 14 19 20 21 22
19,9,431092,430960,132,8,3.823,no_improvement,11 14 16 17 22 23
19,10,735520,735570,50,2,2.021,no_improvement,3 6 8 13 16 18 19 21 22
19,11,737785,737788,3,3,2.009,no_improvement,0 1 2 4 10 11 12 21 22 23
19,12,207852,207883,31,3,2.058,no_improvement,2 3 8 19
19,13,884427,884416,11,4,2.027,no_improvement,2 5 8 9 12 14 15 17 20 21 23
19,14,257591,257562,29,4,2.149,no_improvement,2 5 6 23
19,15,143042,143042,0,2,1.357,zero_fitness,2 5 22
20,1,325608,325633,25,4,2.370,no_improvement,2 4 5 6 14 18 23
20,2,807486,807492,6,3,2.275,no_improvement,0 1 5 9 10 11 14 15 23
20,3,571315,571317,2,4,1.935,no_improvement,0 2 9 11 12 16 21 22 23
20,4,646671,646987,316,2,1.405,no_improvement,0 3 5 6 7 8 9 15 20
20,5,552333,552375,42,2,1.430,no_improvement,0 10 11 13 15 20 21 23
20,6,497840,497810,30,5,2.037,no_improvement,3 7 9 10 12 19 20 21 23
20,7,815405,815434,29,3,2.148,no_improvement,2 3 4 6 7 9 12 13 14 18 20 21 22
20,8,249493,249508,15,5,2.927,no_improvement,7 9 13 15
20,9,364519,364506,13,5,3.421,no_improvement,2 7 8 11 12
20,10,391390,391384,6,3,2.220,no_improvement,6 9 23
20,11,871384,871344,40,3,1.221,no_improvement,0 6 7 9 10 11 13 15 16 23
20,12,415252,415211,41,2,2.389,no_improvement,0 5 12 17 19 20
20,13,757297,757355,58,5,2.524,no_improvement,0 2 3 6 8 9 11 12 18 20 21 22
20,14,842657,842760,103,2,1.225,no_improvement,0 2 5 8 10 11 13 14 15 17
20,15,308898,308935,37,6,3.381,no_improvement,4 8 12 15 17 19 20
21,1,341803,341814,11,4,2.303,no_improvement,0 2 5 6 7 8 19 20 22 23
21,2,204531,204660,129,4,3.022,no_improvement,1 11 12 20
21,3,515335,515320,15,3,1.202,no_improvement,1 4 9 10 13 16 19 22 23
21,4,614806,614827,21,4,2.010,no_improvement,0 2 3 5 6 9 13 15 16 20
21,5,567268,567259,9,2,1.074,no_improvement,2 3 5 6 8 15 17 18
21,6,865524,865514,10,8,4.823,no_improvement,2 7 8 9 12 14 15 16 21 22
21,7,589042,589077,35,2,1.185,no_improvement,0 3 9 10 13 16 18 19 22
21,8,473113,473161,48,6,3.455,no_improvement,6 7 11 15 18 20
21,9,152682,152562,120,4,2.043,no_improvement,8 11 23
21,10,140538,140305,233,4,2.570,no_improvement,2 8 20 22 23
21,11,375415,375311,104,4,2.313,no_improvement,1 6 10 19 20 23
21,12,286509,286025,484,2,2.014,no_improvement,4 6 7 8 14 16 22
21,13,273129,272918,211,3,2.146,no_improvement,0 2 5 6 8 9 19 22
21,14,283778,283728,50,2,1.220,no_improvement,1 2 8 11 13 16
21,15,956825,956860,35,3,1.507,no_improvement,0 5 7 8 10 11 15 16 19 21 23
22,1,950551,950448,103,2,1.093,no_improvement,0 1 3 4 5 7 9 11 13 20 23
22,2,923041,923114,73,5,3.817,no_improvement,0 2 3 9 12 13 16 18 20 21 22
22,3,342330,342337,7,3,1.004,no_improvement,3 4 12 20 21
22,4,404911,404864,47,6,4.496,no_improvement,0 2 6 8 12 17 21 22
22,5,778835,778671,164,5,3.131,no_improvement,0 5 6 7 10 11 12 16 19 20 23
22,6,783001,782385,616,2,1.443,no_improvement,0 5 7 8 9 12 14 19 20 22 23
22,7,688545,688473,72,2,1.004,no_improvement,1 4 6 14 15 16 19 20 21
22,8,174745,171955,2790,2,1.189,no_improvement,3 14
22,9,717775,717757,18,5,3.521,no_improvement,0 1 5 7 9 10 12 14 15 16 18 23
22,10,502897,502974,77,3,1.120,no_improvement,0 11 15 16 17 20 21
22,11,635107,635001,106,2,1.267,no_improvement,2 3 5 14 15 16 17 19 20 22
22,12,1047472,1047570,98,3,1.268,no_improvement,1 3 4 7 14 16 17 19 22 23
22,13,286244,286217,27,5,2.381,no_improvement,2 9 10 14 18 21
22,14,955160,955133,27,4,4.000,no_improvement,0 1 2 3 6 7 9 11 17 18 22 23
22,15,383660,383958,298,3,1.214,no_improvement,4 6 12 13 16 17 18 21 22
23,1,440950,440941,9,2,2.004,no_improvement,0 1 2 3 4 8 11 16 22
23,2,303008,303013,5,5,2.554,no_improvement,3 7 9 11 13 16 22 23
23,3,413401,413388,13,3,2.450,no_improvement,0 1 2 7 8 10 11 13 15 21
23,4,198430,198424,6,10,4.528,no_improvement,6 7 12 13 16 17
23,5,548908,548863,45,3,2.017,no_improvement,2 3 5 9 11 15 17 18 21 22
23,6,328220,328010,210,3,2.015,no_improvement,0 1 2 3 6 13 14 16 18
23,7,542009,541976,33,4,2.109,no_improvement,1 7 8 10 11 14 19 23
23,8,519975,519955,20,4,3.072,no_improvement,0 4 6 7 9 10 12 13 14 18 23
23,9,321708,321664,44,3,2.027,no_improvement,2 8 11 20 21
23,10,441230,441229,1,5,2.422,no_improvement,0 4 11 13 15 17 19 23
23,11,552175,552181,6,4,2.223,no_improvement,0 2 6 9 11 12 15 16 18
23,12,279129,278846,283,5,3.549,no_improvement,1 7 9 10 15 17 19
23,13,146449,146513,64,7,3.258,no_improvement,1 6 15
23,14,269376,269384,8,5,3.241,no_improvement,6 10 18 19 20
23,15,602933,602977,44,2,1.609,no_improvement,2 3 4 6 7 14 15 17
24,1,731684,731671,13,2,1.035,no_improvement,1 3 7 9 10 14 16 20 21 22
24,2,757194,757159,35,3,2.441,no_improvement,0 2 3 5 6 7 9 10 11 13 16 21
24,3,733438,733436,2,5,3.046,no_improvement,2 3 4 6 8 11 12 15 16 17 19 23
24,4,309619,309578,41,4,2.473,no_improvement,3 4 15 17 18 22
24,5,659354,659394,40,2,0.000,no_improvement,2 5 6 7 8 9 11 13 15 17 22
24,6,753999,753856,143,2,1.064,no_improvement,0 1 6 14 15 16 20 21 22 23
24,7,151950,151974,24,2,1.544,no_improvement,5 8 15 21 22
24,8,822015,821967,48,5,3.079,no_improvement,1 4 5 7 8 9 11 14 15 20 22
24,9,397370,397509,139,2,1.533,no_improvement,0 4 7 14 20 21 22 23
24,10,239748,239828,80,5,2.560,no_improvement,0 3 5 18 20
24,11,656054,656068,14,3,2.090,no_improvement,5 10 11 12 14 17 18 21 23
24,12,347939,347819,120,5,3.144,no_improvement,5 6 8 10 11 12 16 17 21
24,13,748848,748958,110,3,2.086,no_improvement,0 1 7 8 12 13 15 18 21 23
24,14,943598,943571,27,4,2.638,no_improvement,0 1 2 6 7 10 13 15 17 20 21 22 23
24,15,531965,531877,88,4,2.565,no_improvement,0 2 5 6 11 13 16 17 20 22
25,1,705509,705498,11,4,2.566,no_improvement,3 6 7 9 10 11 16 23
25,2,945175,945160,15,5,3.177,no_improvement,0 1 2 3 4 6 8 9 13 16 20 21
25,3,221456,221421,35,4,2.045,no_improvement,0 3 4 12 13 17 21
25,4,423356,423360,4,4,2.010,no_improvement,1 3 8 9 17 21
25,5,660494,660511,17,3,2.041,no_improvement,0 1 3 4 8 11 13 14 18
25,6,695944,695991,47,4,3.027,no_improvement,1 5 8 9 13 15 16 18 21 23
25,7,290303,290232,71,7,3.755,no_improvement,9 12 14 15 19 21
25,8,939232,939099,133,3,2.018,no_improvement,1 2 3 6 7 11 14 15 17 18 19 21 22
25,9,636576,636586,10,5,4.286,no_improvement,0 5 6 7 8 9 12 14 21 23
25,10,54037,54354,317,5,2.097,no_improvement,3 11 14 23
25,11,387841,387838,3,4,2.498,no_improvement,2 5 10 13 14 15 17 22 23
25,12,379406,379296,110,3,2.187,no_improvement,1 4 6 20 22
25,13,466311,466349,38,2,1.472,no_improvement,1 9 10 13 14 18 21
25,14,661307,661181,126,3,1.433,no_improvement,0 1 2 7 10 11 12 17 19 21 22 23
25,15,587298,587298,0,5,3.533,zero_fitness,0 3 5 11 13 16 19 20 21
26,1,673724,673760,36,3,1.487,no_improvement,2 5 7 9 10 11 13 20 22 23
26,2,732128,732116,12,4,2.452,no_improvement,0 1 4 5 7 10 11 12 13 18 22 23
26,3,440471,440441,30,3,2.488,no_improvement,0 3 4 5 7 10 13 17 21 22
26,4,203941,204015,74,5,2.423,no_improvement,8 9 12 16 17
26,5,528814,528773,41,3,2.522,no_improvement,2 3 4 8 12 16 21 22
26,6,497866,497866,0,5,2.276,zero_fitness,1 3 5 7 9 10 12 14 16 19 21 23
26,7,312630,312611,19,2,2.507,no_improvement,1 4 6 18 20
26,8,219728,219714,14,6,3.113,no_improvement,1 3 5 6 7 9 13 17 18 22
26,9,616458,616420,38,4,2.530,no_improvement,1 2 9 10 13 15 18 19 20
26,10,737162,737147,15,3,2.035,no_improvement,0 3 5 6 8 11 13 18 20 21 22
26,11,120314,120301,13,4,2.049,no_improvement,0 1 9 10
26,12,366917,366844,73,6,3.045,no_improvement,1 4 7 8 12 15 16 17 22
26,13,193288,193260,28,3,1.913,no_improvement,3 14 16 21 23
26,14,449925,449522,403,2,2.123,no_improvement,0 2 5 7 8 12 13 14 15 18 22
26,15,415007,415032,25,6,3.008,no_improvement,0 1 8 13 14 15 16 17 22
27,1,716487,716587,100,7,4.082,no_improvement,1 2 3 5 6 9 12 15 16 19 21
27,2,746382,746374,8,5,2.499,no_improvement,4 6 7 8 9 11 12 16 17 20 21
27,3,1068733,1068809,76,8,4.359,no_improvement,0 1 2 3 4 6 7 8 9 14 15 17 19 20 21 22 23
27,4,572753,572740,13,4,2.335,no_improvement,1 2 3 4 7 9 12 16 17 18 20 21 23
27,5,396389,396326,63,4,2.804,no_improvement,3 5 7 8 10 16 19 20
27,6,296532,296520,12,2,2.089,no_improvement,3 6 7 16 19 23
27,7,417217,417221,4,2,1.160,no_improvement,8 9 10 20 22
27,8,760425,760338,87,2,1.389,no_improvement,2 3 4 14 15 18 19 20 21
27,9,487461,487418,43,4,2.559,no_improvement,3 6 9 11 16 18 19
27,10,645105,645066,39,3,1.460,no_improvement,1 4 7 8 10 12 15 18 22 23
27,11,562566,562575,9,3,2.040,no_improvement,5 7 13 19 21 22
27,12,815721,815553,168,2,2.003,no_improvement,2 3 6 7 8 15 17 21 23
27,13,478975,478961,14,4,2.006,no_improvement,1 12 13 15 18 20
27,14,746781,746787,6,2,1.002,no_improvement,0 9 14 17 18 19 20 21 22
27,15,827741,827734,7,2,2.006,no_improvement,2 3 4 10 12 13 15 16 17 19 22
28,1,739698,739635,63,2,1.002,no_improvement,1 2 3 5 8 11 12 13 15 20 22
28,2,609926,610015,89,5,3.363,no_improvement,0 1 3 4 10 12 14 15 17 19 22
28,3,371050,371180,130,4,3.188,no_improvement,0 1 5 9 11 14 17 19
28,4,507455,507453,2,5,2.305,no_improvement,0 5 6 10 14 20 22
28,5,246538,246525,13,4,2.221,no_improvement,3 5 9 14 15 17
28,6,451831,452018,187,3,2.157,no_improvement,0 1 3 4 11 12 14 15 16 19 21 22
28,7,571682,571689,7,3,2.014,no_improvement,3 5 7 11 12 16 17 18 21 23
28,8,483372,483239,133,4,2.067,no_improvement,2 3 4 5 6 7 13 14 16 18 19 20 22
28,9,124270,124177,93,6,3.948,no_improvement,4 5 13 14
28,10,767715,767712,3,6,3.048,no_improvement,0 2 3 4 5 8 9 11 17 18 19 20
28,11,735317,735329,12,2,1.344,no_improvement,0 1 4 5 6 8 11 12 13 17 18 20 23
28,12,199641,199459,182,2,2.184,no_improvement,1 3 7 18 22
28,13,481394,481563,169,3,2.005,no_improvement,0 1 4 8 14 15 21
28,14,374673,374648,25,4,2.526,no_improvement,1 6 8 9 11 14 15 17 21 22
28,15,765541,765434,107,4,2.004,no_improvement,1 2 7 10 13 14 15 17 19 20
29,1,397378,397277,101,2,2.004,no_improvement,1 2 5 7 8 9 13 16
29,2,683021,682871,150,5,2.153,no_improvement,5 8 9 10 11 15 16 17 18 22 23
29,3,158436,158436,0,5,3.098,zero_fitness,7 11 17 18
29,4,485103,485142,39,2,1.276,no_improvement,4 6 8 11 12 14 16 21 22
29,5,635630,635652,22,4,2.015,no_improvement,4 6 7 8 10 12 14 15 17 20
29,6,401848,401856,8,6,3.044,no_improvement,0 3 4 6 9 18 19
29,7,460175,460151,24,3,2.054,no_improvement,2 7 8 13 15 16 22 23
29,8,569488,569484,4,5,3.605,no_improvement,2 3 6 7 9 18 20 21
29,9,351740,351779,39,4,2.390,no_improvement,2 4 8 10 13 16 18
29,10,332177,332178,1,5,3.102,no_improvement,0 4 7 8 12 13 14 17 18
29,11,216215,216200,15,4,2.509,no_improvement,3 4 5 7 17 20 23
29,12,232818,232667,151,3,2.093,no_improvement,1 5 8 15
29,13,557030,557036,6,5,3.016,no_improvement,0 3 4 9 11 13 14 22
29,14,735073,735074,1,7,3.699,no_improvement,0 1 2 4 6 7 9 10 11 12 18 19 20 22 23
29,15,1035457,1035446,11,6,3.724,no_improvement,0 1 4 5 6 8 9 10 12 15 16 19 21 22 23
30,1,247209,247279,70,4,2.085,no_improvement,2 7 10 14 17 22 23
30,2,517724,517740,16,5,3.011,no_improvement,2 3 7 8 10 12 14 20 22 23
30,3,459941,459911,30,6,3.507,no_improvement,5 7 8 9 11 12 13 16 20 23
30,4,334544,334679,135,4,2.010,no_improvement,10 11 12 17 18 19 20 23
30,5,466077,465939,138,4,2.097,no_improvement,0 7 8 9 16 18
30,6,508172,508191,19,3,2.003,no_improvement,2 4 6 7 8 18 23
30,7,199823,199854,31,2,1.004,no_improvement,4 7 9 10 11
30,8,140429,140866,437,3,2.560,no_improvement,9 11 12 21
30,9,425526,425507,19,5,2.316,no_improvement,0 1 4 7 8 13 17 23
30,10,498930,498927,3,4,2.335,no_improvement,1 3 6 11 13 16 18 21 22
30,11,812062,812030,32,7,4.548,no_improvement,1 3 6 7 8 9 10 11 12 14 16 18 19 22
30,12,493449,493462,13,5,2.048,no_improvement,1 2 3 4 6 7 10 11 19 21 23
30,13,56327,56827,500,2,1.033,no_improvement,3 5
30,14,426743,426738,5,2,1.006,no_improvement,7 8 13 14 19 20 21
30,15,343897,343890,7,4,2.268,no_improvement,0 2 3 7 17 21 22
31,1,142619,142118,501,4,2.603,no_improvement,8 9 12 13
31,2,837299,837256,43,3,2.065,no_improvement,0 1 3 7 8 14 15 16 21 23
31,3,159627,159627,0,7,3.699,zero_fitness,0 4
31,4,539440,539402,38,5,3.332,no_improvement,3 6 7 10 15 20 23
31,5,251240,251339,99,6,3.688,no_improvement,3 7 8 10 17 20
31,6,267632,267919,287,4,2.009,no_improvement,0 2 3
31,7,808347,808406,59,3,2.049,no_improvement,1 2 5 14 15 16 23
31,8,148716,148878,162,3,2.382,no_improvement,10 13
31,9,1006546,1006564,18,3,2.022,no_improvement,0 1 4 8 9 12 14 15 17 19 23
31,10,1144658,1144724,66,4,2.365,no_improvement,0 1 2 3 4 6 7 8 9 10 15 17 22
31,11,860494,860495,1,4,2.896,no_improvement,5 9 10 12 14 19 22 23
31,12,577329,577250,79,3,1.003,no_improvement,0 1 2 5 7 9 12 16 19 21 22
31,13,279659,279740,81,4,2.026,no_improvement,2 8 9 11 20
31,14,1071910,1072158,248,3,1.442,no_improvement,6 7 9 10 13 14 15 17 19 20 23
31,15,954170,954138,32,4,3.144,no_improvement,1 3 4 7 11 15 16 17 19 23
32,1,787887,787959,72,5,2.340,no_improvement,2 3 7 13 15 16 18 19 22
32,2,966144,966166,22,3,1.126,no_improvement,0 2 4 5 7 8 11 12 15 19 23
32,3,78710,78710,0,5,3.026,zero_fitness,3 17
32,4,674402,674354,48,3,2.087,no_improvement,2 3 5 6 8 9 15 17 22
32,5,826279,826308,29,3,2.005,no_improvement,5 10 15 19 20 21 23
32,6,441434,441488,54,8,4.045,no_improvement,0 3 7 10 13 15 17
32,7,946263,946245,18,2,1.057,no_improvement,1 4 5 7 10 13 17 18 23
32,8,214481,214999,518,4,2.585,no_improvement,11 15 22
32,9,1044410,1044394,16,7,4.009,no_improvement,0 2 4 7 9 10 12 13 16 17 19 22
32,10,531727,531798,71,2,1.004,no_improvement,2 4 8 9 12 13 14 15 18 22
32,11,553495,553558,63,2,1.507,no_improvement,4 7 8 10 11
32,12,392771,392827,56,6,4.192,no_improvement,2 4 7 10 21 23
32,13,1088236,1088340,104,6,3.006,no_improvement,0 2 3 6 9 12 13 14 19 21 23
32,14,1105987,1106174,187,3,2.042,no_improvement,1 4 7 9 10 11 12 16 17 22 23
32,15,998902,998717,185,2,1.500,no_improvement,0 5 6 8 9 11 15 16 17 18 19 22
33,1,846589,846715,126,4,2.001,no_improvement,0 4 6 8 9 10 11 12 13 16 17 18 19 22
33,2,544555,544599,44,5,3.243,no_improvement,2 4 8 12 15 18 21 22
33,3,703117,703076,41,3,2.048,no_improvement,1 9 13 14 15 17 18 20 21 22
33,4,90703,90703,0,8,4.569,zero_fitness,6 11 21
33,5,214205,214307,102,7,3.311,no_improvement,6 8 14 18 19 21
33,6,593357,593385,28,4,2.017,no_improvement,0 1 2 9 13 14 17 19 20
33,7,472532,472548,16,4,2.914,no_improvement,4 5 6 8 13 14 18 21 22
33,8,744014,743930,84,4,3.190,no_improvement,4 7 8 11 13 14 16 18 19 22
33,9,397665,397602,63,6,3.003,no_improvement,3 4 10 12 15 16 19
33,10,509428,509367,61,2,1.003,no_improvement,2 3 4 5 10 14 19 21
33,11,1075386,1075371,15,5,2.994,no_improvement,0 2 3 5 7 8 9 12 15 17 18 21 22
33,12,128870,128894,24,2,1.003,no_improvement,1 11 16 23
33,13,549540,549439,101,4,2.382,no_improvement,1 6 10 11 14 17 20 21 22 23
33,14,291045,290949,96,3,2.006,no_improvement,6 9 19 23
33,15,92372,93622,1250,3,2.052,no_improvement,9 10 11 14
34,1,246397,246865,468,5,2.009,no_improvement,15 18 20
34,2,153899,154003,104,3,2.121,no_improvement,1 4 13 21
34,3,151822,151884,62,4,2.003,no_improvement,0 2 5 9 11 22
34,4,717072,716904,168,4,2.027,no_improvement,0 4 5 10 11 14 16 17 19 23
34,5,251057,251065,8,3,2.053,no_improvement,4 7 9 11 15 16
34,6,272159,272065,94,4,2.506,no_improvement,1 15 17 23
34,7,247382,247349,33,5,2.042,no_improvement,3 5 7 11 19 20 22 23
34,8,768714,768717,3,3,2.141,no_improvement,0 1 3 5 7 8 15 16 17 20 21
34,9,856681,856682,1,2,2.178,no_improvement,0 1 3 7 8 15 16 17 18 21
34,10,439797,439780,17,3,1.003,no_improvement,2 3 8 10 17 19 20 23
34,11,205935,205934,1,12,6.315,no_improvement,4 5 8 11 19 22
34,12,345791,345868,77,4,2.368,no_improvement,11 14 18 22
34,13,598933,598896,37,2,1.002,no_improvement,3 4 5 9 11 13 15 16 18 20
34,14,361138,361052,86,3,3.000,no_improvement,3 5 11 12 18 21 22
34,15,632257,632258,1,4,2.315,no_improvement,2 5 6 8 10 14 15 18
35,1,544940,545042,102,2,1.002,no_improvement,0 1 3 6 8 9 10 14 15 16 19 23
35,2,671463,671411,52,6,3.628,no_improvement,3 5 6 8 9 11 12 16 19 21
35,3,566229,566164,65,2,1.275,no_improvement,0 2 5 7 10 17 19 23
35,4,57302,57104,198,3,2.116,no_improvement,3 4 8 11 12 15 18 20 21
35,5,674551,674513,38,4,2.345,no_improvement,3 4 5 6 10 12 13 15 16 18 20
35,6,806683,806708,25,4,2.165,no_improvement,1 3 4 5 6 8 10 13 14 15 18 19 21 22
35,7,233536,233485,51,4,2.007,no_improvement,3 13 15 16 18 20 22
35,8,289585,289614,29,3,1.507,no_improvement,6 10 11 13 15 16 17
35,9,525950,525947,3,3,2.097,no_improvement,0 2 3 5 6 9 10 11 12 17 22 23
35,10,137585,137556,29,4,2.005,no_improvement,3 6 9 17 18
35,11,144913,144975,62,6,3.072,no_improvement,5 9 15 17 18 21 23
35,12,170003,170092,89,4,2.504,no_improvement,3 6 9 15 18 23
35,13,241909,241929,20,4,2.150,no_improvement,1 2 3 5 8 9 13 17 18 21 22
35,14,44580,47015,2435,2,1.003,no_improvement,18 22
35,15,356573,356598,25,3,2.192,no_improvement,1 14 18 19 22
36,1,615263,615306,43,4,3.425,no_improvement,0 1 4 6 9 10 14 16 20 21 23
36,2,317978,318005,27,7,4.025,no_improvement,0 3 5 14 19
36,3,579871,579894,23,3,1.207,no_improvement,0 6 9 10 12 13 15 16 18 21
36,4,578306,578218,88,4,2.422,no_improvement,1 5 8 10 11 16 23
36,5,782510,782525,15,6,3.453,no_improvement,4 5 6 8 10 11 12 15 16 20 22 23
36,6,266661,266649,12,5,3.340,no_improvement,0 2 3 10 17 20 21
36,7,658948,658982,34,2,1.030,no_improvement,0 1 6 8 11 16 17 19 20 23
36,8,690011,690116,105,2,2.081,no_improvement,0 1 2 6 7 8 9 17 18 21 23
36,9,599095,599133,38,4,2.044,no_improvement,0 5 6 9 12 13 17 21
36,10,678178,678288,110,2,2.013,no_improvement,0 1 5 8 9 14 15 18 19 21
36,11,610039,610075,36,5,3.082,no_improvement,4 6 7 8 12 13 16 19 22
36,12,417898,417855,43,5,2.891,no_improvement,0 5 11 14 15 16 18
36,13,630846,630738,108,4,2.297,no_improvement,0 1 4 6 10 11 15 16 19 20
36,14,277811,277700,111,3,2.318,no_improvement,3 9 12 15 19 20 21 22 23
36,15,138035,137854,181,6,3.152,no_improvement,1 2 10 14 16
37,1,498670,498603,67,3,2.282,no_improvement,2 6 11 15 16 17 20 21
37,2,466036,466107,71,2,1.104,no_improvement,1 9 11 13 23
37,3,305292,305369,77,2,1.256,no_improvement,4 5 6 9 16 22
37,4,369948,369857,91,3,2.414,no_improvement,2 7 8 13 19 23
37,5,655170,655169,1,7,3.733,no_improvement,0 6 7 9 13 14 15 16 17 19 20 21 22
37,6,821254,821229,25,3,2.014,no_improvement,0 1 3 4 5 9 10 17 18 20 21 23
37,7,554783,554703,80,2,1.003,no_improvement,2 7 10 13 14 17 18 20 21 22
37,8,77945,77945,0,1,1.149,zero_fitness,13 21
37,9,475790,475765,25,3,1.104,no_improvement,1 3 5 8 10 14 18 19 21 23
37,10,698318,698351,33,3,1.018,no_improvement,1 3 7 8 9 10 12 14 16 17 20 21 23
37,11,546990,546953,37,2,2.384,no_improvement,9 11 12 13 15 16 20
37,12,403672,403703,31,6,3.412,no_improvement,6 7 12 14 16 17 19 22
37,13,644867,644744,123,3,1.340,no_improvement,1 3 7 11 12 13 17 18 19 23
37,14,260124,259834,290,2,1.907,no_improvement,0 1 8 12 17 19 22
37,15,129756,129716,40,5,2.102,no_improvement,5 8 10 12 20 21
38,1,752587,752602,15,3,2.468,no_improvement,0 1 2 5 14 15 16 17 18 20 22
38,2,296475,296439,36,3,1.479,no_improvement,2 4 7 14 16 19
38,3,629936,629903,33,4,2.276,no_improvement,0 2 6 9 10 13 17 21 23
38,4,349426,349346,80,3,1.932,no_improvement,7 8 12 22
38,5,643448,643425,23,2,2.123,no_improvement,0 1 2 5 8 11 12 14 16 23
38,6,367394,367461,67,4,2.107,no_improvement,2 3 5 8 10 18 23
38,7,809850,809726,124,2,1.033,no_improvement,1 2 7 9 13 17 19 20 21 23
38,8,349712,349563,149,5,3.323,no_improvement,0 1 2 4 5 8 11 13 14 18 20
38,9,573797,573784,13,7,3.797,no_improvement,0 1 3 4 5 7 14 17 18 21 22 23
38,10,858462,858437,25,2,2.075,no_improvement,1 7 12 16 17 18 19 22
38,11,373282,373276,6,4,2.231,no_improvement,0 7 10 11 14 22
38,12,170098,168973,1125,2,1.101,no_improvement,4 6 7 10 19
38,13,653875,653856,19,4,2.661,no_improvement,1 6 7 8 11 16 21
38,14,714702,714682,20,3,2.036,no_improvement,0 2 3 7 11 17 18 20 21 22 23
38,15,57401,57593,192,2,1.412,no_improvement,4 7 20
39,1,459090,459061,29,2,1.100,no_improvement,0 9 10 12 13 14 16
39,2,682587,682616,29,5,3.153,no_improvement,2 4 7 14 15 16 17 23
39,3,655150,655115,35,4,2.510,no_improvement,3 4 5 8 9 15 19 20 23
39,4,136470,136481,11,3,2.071,no_improvement,0 12 20
39,5,531381,531413,32,5,2.403,no_improvement,1 4 5 10 12 18 19 20 21
39,6,801385,801388,3,3,2.541,no_improvement,1 2 3 4 5 6 7 9 10 17 21 22
39,7,501450,501518,68,8,4.526,no_improvement,0 3 5 6 7 19 21 23
39,8,914364,914342,22,7,4.032,no_improvement,0 3 4 5 6 7 11 13 17 18 23
39,9,726825,726824,1,4,2.008,no_improvement,0 1 5 6 7 11 13 14 15 16 18 20 21
39,10,289310,289537,227,2,1.005,no_improvement,9 13 16 22
39,11,1018209,1018146,63,4,3.072,no_improvement,0 2 3 6 7 8 10 11 13 14 17 20 21 23
39,12,974085,974140,55,7,3.555,no_improvement,0 3 5 7 8 10 11 18 21 22 23
39,13,925873,925890,17,4,2.142,no_improvement,4 8 13 14 17 18 19 20 23
39,14,154804,153980,824,4,2.072,no_improvement,1 5 10 11 16 21
39,15,532388,532359,29,4,2.533,no_improvement,1 3 5 13 15 21 23
40,1,285776,285810,34,4,3.328,no_improvement,0 5 7 12 18 22
40,2,645086,645076,10,3,1.158,no_improvement,14 16 18 20 21
40,3,486484,486441,43,2,2.139,no_improvement,0 6 12 15 16 17 22 23
40,4,884479,884380,99,7,3.728,no_improvement,0 1 6 7 13 15 16 17 18 21 23
40,5,280857,281409,552,2,2.032,no_improvement,0 4 5 11 13 19 23
40,6,343968,343964,4,4,2.238,no_improvement,1 10 12 17 20 23
40,7,186114,186129,15,5,2.301,no_improvement,1 4 13 19 21 22 23
40,8,807280,807264,16,5,2.809,no_improvement,0 4 5 6 7 8 10 12 15 16 20 21 23
40,9,861226,861297,71,4,2.394,no_improvement,1 4 6 8 9 10 11 12 14 16 17 19
40,10,637850,638068,218,2,1.042,no_improvement,4 8 9 11 15 16 20 22
40,11,597498,597510,12,5,2.224,no_improvement,3 7 11 13 18 20 22
40,12,583311,583307,4,2,2.103,no_improvement,1 4 6 9 10 12 15 19 22 23
40,13,507276,507305,29,3,1.506,no_improvement,1 2 3 4 5 6 8 10 11 14 15 20 21
40,14,610645,610666,21,3,2.083,no_improvement,6 7 13 15 16 19 22
40,15,731101,731102,1,3,2.010,no_improvement,0 2 3 5 6 8 9 11 18 20 21 22
41,1,387228,387424,196,3,2.141,no_improvement,0 5 6 7 11 16 23
41,2,621953,621967,14,8,4.041,no_improvement,6 7 9 11 15 16 18 20 22
41,3,332344,332357,13,4,3.128,no_improvement,0 15 16 17 19 21
41,4,794960,794863,97,3,1.182,no_improvement,1 2 3 4 6 9 13 15 16 17 18 21
41,5,358453,358520,67,3,2.144,no_improvement,3 9 11 13 15 16 19 21 22
41,6,822359,822266,93,6,4.064,no_improvement,1 4 6 7 8 11 18 19 21 22 23
41,7,735964,735835,129,2,1.045,no_improvement,3 4 5 7 9 13 14 15 16 18 20 22
41,8,691527,691495,32,7,4.442,no_improvement,0 1 5 8 9 12 13 16 19 20 21
41,9,338354,338448,94,3,1.449,no_improvement,1 3 6 8 11 14 15 17 18 20
41,10,454202,454024,178,3,1.115,no_improvement,0 1 6 7 9 13 15 23
41,11,331348,331329,19,8,3.496,no_improvement,5 7 9 14 17 22
41,12,754084,754087,3,7,4.703,no_improvement,1 2 4 5 7 8 9 13 17 18 19
41,13,726220,726196,24,4,2.001,no_improvement,0 1 2 5 10 11 12 13 14 15 16 17 18 19 22
41,14,346140,346139,1,4,2.101,no_improvement,0 4 13 15 19
41,15,199702,199596,106,7,4.481,no_improvement,1 7 9 12 13 15 17
42,1,807785,807812,27,2,2.145,no_improvement,5 6 7 9 10 17 18 22 23
42,2,741247,741446,199,2,1.344,no_improvement,5 6 7 8 10 12 18 19 21 23
42,3,652746,652803,57,2,0.997,no_improvement,1 2 3 8 9 14 15 19 23
42,4,265675,265660,15,7,4.516,no_improvement,0 1 2 4 8 16
42,5,242013,241991,22,6,2.250,no_improvement,2 7 12 13 14 15 16 18
42,6,768795,768775,20,2,1.015,no_improvement,1 3 5 6 7 9 13 14 16 17
42,7,518500,518253,247,3,1.501,no_improvement,0 1 3 4 6 9 12 19 20
42,8,881459,881434,25,3,2.328,no_improvement,2 3 4 7 8 9 10 15 17 18 22
42,9,804096,803975,121,2,1.002,no_improvement,1 4 6 7 8 9 12 15 16 18 20 21 22
42,10,356519,356569,50,4,3.230,no_improvement,0 2 3 4 5 12 14 17 18
42,11,181462,182266,804,2,1.337,no_improvement,0 2 4 10 14 18 20 22 23
42,12,291818,291960,142,6,2.973,no_improvement,9 15 18
42,13,873613,873596,17,9,6.399,no_improvement,2 3 4 7 10 11 12 15 16 17 23
42,14,764672,764620,52,5,2.621,no_improvement,0 3 4 5 9 10 13 14 15 19
42,15,705375,705390,15,3,1.468,no_improvement,0 1 2 3 4 5 8 16 19 22
43,1,445090,445098,8,7,4.806,no_improvement,0 4 7 9 19 20 21
43,2,544572,544510,62,2,1.188,no_improvement,1 6 7 8 10 12 19 20 23
43,3,932528,932548,20,3,1.437,no_improvement,5 7 9 10 13 14 16 20 21 22 23
43,4,1037837,1037782,55,6,3.810,no_improvement,0 2 3 5 6 9 11 12 16 17 18 20 22 23
43,5,367186,367079,107,4,2.377,no_improvement,6 9 11 12 15 17 20 22
43,6,850472,850446,26,8,4.441,no_improvement,0 1 4 7 10 11 12 13 18 20 22
43,7,356173,356132,41,2,1.038,no_improvement,0 1 3 4 11 13 18 19 23
43,8,227681,227643,38,7,3.155,no_improvement,2 5 7 9 11 12 16 17 18 20 21 22 23
43,9,247588,247582,6,7,3.520,no_improvement,1 9 16 19 20
43,10,666216,666173,43,3,1.500,no_improvement,2 6 11 12 13 14 17 19 22 23
43,11,849363,849301,62,2,1.092,no_improvement,0 1 2 3 4 8 9 13 16 17
43,12,272372,272386,14,4,2.418,no_improvement,2 3 11 18 21
43,13,729215,729202,13,4,3.140,no_improvement,3 4 5 6 7 8 10 13 14 17 18 19 22 23
43,14,361344,361347,3,3,2.033,no_improvement,0 1 5 16 17 20
43,15,819605,819749,144,2,1.501,no_improvement,1 7 8 9 12 13 17 19 20 22
44,1,388433,388430,3,2,1.000,no_improvement,1 2 4 5 10 14 17 18 22 23
44,2,780006,780011,5,4,3.029,no_improvement,1 8 9 10 11 14 16 17 18 20 22
44,3,114942,114942,0,7,3.299,zero_fitness,4 5 16
44,4,169813,169813,0,5,3.254,zero_fitness,9 16 22
44,5,335323,335357,34,6,3.201,no_improvement,0 6 10 13 16 17
44,6,224920,224807,113,8,4.545,no_improvement,2 4 7 9 10 13 15 18 23
44,7,723176,723173,3,6,2.882,no_improvement,2 4 5 6 7 11 12 13 14 15 22
44,8,503996,504020,24,4,3.100,no_improvement,2 5 8 10 12 13 20 21 22 23
44,9,460160,460161,1,6,3.491,no_improvement,4 11 12 15 16 22
44,10,227022,226488,534,3,1.015,no_improvement,6 7 13 23
44,11,217057,217049,8,7,5.045,no_improvement,4 5 10 12 22
44,12,510864,510845,19,4,2.199,no_improvement,1 2 3 6 11 19
44,13,417524,417575,51,5,3.352,no_improvement,1 5 9 11 13 18 22
44,14,885334,885400,66,2,0.998,no_improvement,2 4 5 6 7 12 13 17 19 20 21
44,15,943572,943531,41,2,1.092,no_improvement,0 1 3 7 8 9 10 11 20 21 22
45,1,227766,227766,0,8,4.474,zero_fitness,2 6 11 23
45,2,432521,432361,160,3,1.170,no_improvement,2 7 20 21
45,3,283423,283268,155,3,1.003,no_improvement,0 1 4 5 6 10 13 14 15 19
45,4,440866,440888,22,2,2.086,no_improvement,6 11 16 17 19 20
45,5,149504,149504,0,4,2.276,zero_fitness,12 23
45,6,226574,226628,54,6,3.240,no_improvement,15 18 19 21
45,7,433444,433524,80,5,2.023,no_improvement,0 2 6 10 11 12 14 16 23
45,8,755653,755613,40,5,3.657,no_improvement,1 3 6 9 11 14 15 17 18 21 22
45,9,192425,192425,0,5,3.355,zero_fitness,3 11
45,10,420943,421072,129,4,2.071,no_improvement,1 8 16 21 23
45,11,57394,57725,331,7,3.697,no_improvement,4 18
45,12,114460,114554,94,5,4.158,no_improvement,18 21
45,13,279397,279476,79,2,1.242,no_improvement,4 7 11 17 18
45,14,371713,371767,54,7,3.790,no_improvement,2 5 6 7 9 13 18
45,15,914548,914576,28,4,4.182,no_improvement,0 3 4 5 7 8 9 11 15 16 17 20 23
46,1,599166,599160,6,7,3.181,no_improvement,1 3 4 5 6 7 11 12 17 23
46,2,209587,209548,39,6,4.012,no_improvement,3 11
46,3,209552,208662,890,2,2.635,no_improvement,0 5 12 14 16 17
46,4,265677,265558,119,6,3.988,no_improvement,5 7 14 18 19 20
46,5,564128,564099,29,4,2.505,no_improvement,0 4 8 9 12 17 18 19
46,6,492091,492064,27,4,2.022,no_improvement,6 7 16 18 19 22
46,7,692982,692995,13,4,1.995,no_improvement,5 7 9 10 13 14 15 19 20 22 23
46,8,373977,373927,50,5,3.427,no_improvement,0 1 7 9 12 15
46,9,651561,651536,25,2,1.470,no_improvement,1 7 10 12 14 15 17 18 19 22 23
46,10,1015774,1015739,35,6,3.756,no_improvement,0 2 3 6 7 8 9 11 13 16 17 19 21
46,11,603068,603033,35,5,2.740,no_improvement,1 8 10 14 17 18 22 23
46,12,803212,803200,12,4,2.366,no_improvement,3 4 5 6 7 10 14 15 20 21 23
46,13,520948,520866,82,3,1.999,no_improvement,7 8 9 16 17 22
46,14,345742,345675,67,3,1.640,no_improvement,1 7 10 12 14 17 22
46,15,977259,977179,80,5,4.590,no_improvement,0 2 5 7 12 13 14 15 21 22
47,1,1084753,1084857,104,4,2.191,no_improvement,4 5 9 10 12 13 14 16 18 19 20 22 23
47,2,1019515,1019434,81,2,2.103,no_improvement,1 5 10 14 16 17 18 19 20 21 23
47,3,183482,183704,222,7,3.775,no_improvement,0 2 4 23
47,4,813279,813387,108,2,1.004,no_improvement,1 3 4 5 8 11 14 15 17 20
47,5,1203442,1203437,5,4,3.338,no_improvement,1 3 5 7 8 9 15 19 20 21 22 23
47,6,568927,568829,98,2,1.004,no_improvement,2 4 6 10 13 15 17 19
47,7,552778,552807,29,3,2.134,no_improvement,0 4 6 7 8 12
47,8,878794,878795,1,4,2.253,no_improvement,0 5 6 8 9 10 12 14 18 19
47,9,250759,250759,0,4,2.120,zero_fitness,10 14 18
47,10,968765,968869,104,2,1.046,no_improvement,4 6 8 11 13 16 17 19 20 21
47,11,217293,217580,287,3,1.006,no_improvement,10 14 18 23
47,12,946872,946964,92,2,2.643,no_improvement,1 3 7 8 9 10 12 18 20 21
47,13,599063,599078,15,7,4.146,no_improvement,0 5 14 16 18 20 22 23
47,14,338415,338573,158,5,4.906,no_improvement,1 9 10 13 14 17 18
47,15,687378,687375,3,6,4.382,no_improvement,0 2 3 5 19 20 23
48,1,211357,211126,231,4,3.064,no_improvement,0 3 6 8 13 16 19 21
48,2,311806,311733,73,3,2.609,no_improvement,0 1 3 5 15 17 21
48,3,105344,105315,29,8,4.483,no_improvement,3 6 15 21
48,4,565379,565451,72,3,1.198,no_improvement,0 2 4 6 9 10 11 14 21 22 23
48,5,401441,401499,58,3,1.002,no_improvement,2 6 10 11 18 19
48,6,666683,666688,5,3,3.164,no_improvement,1 2 8 11 13 15 16 20 22 23
48,7,324303,324183,120,2,1.343,no_improvement,0 2 3 4 9 12 19 21 22
48,8,663879,663857,22,6,3.009,no_improvement,0 1 3 14 16 17 19 20 21 23
48,9,314124,314105,19,4,3.311,no_improvement,3 5 8 13 15 19 20
48,10,545133,545127,6,5,2.528,no_improvement,4 6 8 11 14 17 20 22 23
48,11,450347,450252,95,2,2.022,no_improvement,1 8 10 12 17 21 22
48,12,443723,443734,11,4,2.007,no_improvement,0 2 3 9 10 11 19 20
48,13,519634,519519,115,2,1.149,no_improvement,4 7 8 11 12 14 15 16 21 23
48,14,110904,111166,262,2,1.099,no_improvement,0 15 19 21 22
48,15,717801,717752,49,4,3.069,no_improvement,1 3 4 5 6 8 9 10 12 16 18 19 21
49,1,291413,291463,50,3,1.225,no_improvement,1 2 4 18 23
49,2,657456,657495,39,4,2.456,no_improvement,0 1 2 4 7 12 14 16 17 20
49,3,456513,456527,14,6,3.199,no_improvement,5 10 11 18 19 20 23
49,4,860270,860292,22,7,4.541,no_improvement,0 1 4 5 7 8 10 11 15 16 17 19
49,5,675251,675369,118,3,1.071,no_improvement,0 2 4 10 11 12 13 19 22 23
49,6,183773,184278,505,2,2.005,no_improvement,3 6 9 11 12 13 23
49,7,523791,523721,70,5,3.427,no_improvement,3 4 9 11 12 18 20 21
49,8,237335,237158,177,3,1.525,no_improvement,1 3 9 12 19
49,9,212605,212573,32,5,3.098,no_improvement,4 17 19 21
49,10,470051,470031,20,5,3.009,no_improvement,1 4 6 7 11 12 15 16 17 19 20
49,11,133714,133608,106,6,3.308,no_improvement,3 4 6 10 13 18 20 22
49,12,90093,90801,708,4,2.156,no_improvement,6 14 21
49,13,235384,235128,256,2,1.563,no_improvement,2 4 18 22
49,14,624453,624510,57,5,3.012,no_improvement,1 4 5 6 7 10 15 18 19 21 23
49,15,121357,121212,145,6,3.769,no_improvement,10 14 21 22
50,1,145628,145604,24,11,5.916,no_improvement,0 5 7 11 13 17 19 20
50,2,695160,695230,70,5,3.218,no_improvement,0 4 6 8 12 13 20 22 23
50,3,585275,585289,14,8,6.490,no_improvement,2 3 4 5 6 9 15 19 20 22
50,4,832283,832308,25,4,3.224,no_improvement,0 7 10 11 12 13 16 17 21 23
50,5,274462,274556,94,3,1.004,no_improvement,1 3 8 10 11 12 14 16
50,6,605375,605333,42,4,3.387,no_improvement,1 4 8 13 14 19 20 22
50,7,488865,488875,10,4,3.989,no_improvement,0 1 10 13 15 20 21
50,8,973284,973275,9,3,1.995,no_improvement,0 3 4 5 7 11 12 13 14 16 20 22 23
50,9,381933,381876,57,4,2.501,no_improvement,2 3 5 9 10 16 21
50,10,311336,311318,18,6,4.179,no_improvement,0 3 10 15 19 21 22
50,11,632391,632376,15,2,1.289,no_improvement,1 2 4 5 7 14 21
50,12,271564,271624,60,5,3.127,no_improvement,4 6 9 10 11 15 17 18 22
50,13,383028,383065,37,5,3.387,no_improvement,0 4 7 8 12 13 18
50,14,482204,482155,49,4,3.395,no_improvement,0 4 8 13 14 20
50,15,341897,341848,49,2,2.603,no_improvement,4 6 9 11 12 16 23
